1111111111111111111
1000001C00000000001
10000010000000C0001
1000001000000000011
1111000000C000001P1
1000C10000000000001
10001E0000100010001
1000010000C0000C001
1111111111111111111