1111111111111111111
1000000000000000001
1000000000000000001
1000000000000000001
11111000000000000P1
1000000000000000001
10000000001000E0001
1000000000C00000001
1111111111111111111