1111111
1P00111
10000E1
1C01001
1111111